Открыть новую вкладку и перейти на нее	Ctrl + t
Просмотреть HTML-код текущей страницы (без возможности редактирования)	Ctrl + u
Добавить текущую веб-страницу в закладки	Ctrl + d
Добавить все открытые вкладки в отдельную папку закладок	Ctrl + Shift +d
Открыть меню Chrome	Alt + e / F10
Открыть инструменты разработчика	Ctrl + Shift + j / F12
Открыть новое окно в режиме инкогнито	Ctrl + Shift + n
Открыть страницу "Скачанные файлы" в новой вкладке	Ctrl + j
Включить или отключить полноэкранный режим	F11
Восстановить масштаб страницы по умолчанию	Ctrl + 0
Прокрутить веб-страницу вверх (одно нажатие – один экран)	Shift + пробел
Прокрутить страницу по горизонтали	Удерживая Shift, прокрутите колесо мыши


Открыть ссылку в текущей вкладке (только мышь)	Перетащите ссылку на вкладку
Открыть ссылку в новой фоновой вкладке	Удерживая Ctrl, нажмите на ссылку
Открыть ссылку и перейти к ней	Удерживая Ctrl + Shift, нажмите на ссылку
Открыть ссылку в новом окне	Удерживая Shift, нажмите на ссылку
Добавить текущую веб-страницу в закладки	Перетащите веб-адрес на панель закладок



Обновить текущую страницу	F5 / Ctrl + r
Обновить текущую страницу без учета кешированного контента	Shift + F5 / Ctrl + Shift + r


Перейти к адресной строке	Ctrl + l / F6
Выполнить поиск из любой области страницы	Ctrl + k / Ctrl + e


Открыть предыдущую страницу из истории просмотров в текущей вкладке	Alt + стрелка влево
Открыть следующую страницу из истории просмотров в текущей вкладке	Alt + стрелка вправо


Перейти на следующую открытую вкладку	Ctrl + Tab
Перейти на предыдущую открытую вкладку	Ctrl + Shift + Tab
Перейти на определенную вкладку	Ctrl + 1 – Ctrl + 8
Перейти на последнюю вкладку	Ctrl + 9


Открыть домашнюю страницу в текущей вкладке	Alt + Home
Закрыть все открытые вкладки и браузер	Ctrl + Shift + w


Открыть диспетчер закладок	Ctrl + Shift + o
Открыть диспетчер задач Chrome	Shift + Esc
Удалить подсказки из адресной строки	Нажмите на стрелку вниз, чтобы выделить нужную область, а затем выберите Shift + Delete
Открыть сохраненный на компьютере файл в Chrome	Нажмите Ctrl + o и выберите файл

















